EA ./textures/troll_east_texture.xpm
SO ./textures/troll_south_texture.xpm
WE ./textures/troll_west_texture.xpm
NO ./textures/troll_north_texture.xpm
F 220,100,0
C 225,30,0

1111   111111111111111
1001  1001 10000000001
1001 1001  10011111001
10011001   1001   1001
1E00001    1001   1001
1001001    1001   1001
10011001   1001   1001
1001 1001  10011111001
1001  1001 10000000001
1111   111111111111111