1111111111111
1000000000001
1001000001001
1000000001001
1000000001001
1001100001111
1000000000001
1111111111111