EA ./textures/east_texture.xpm
SO ./textures/south_texture.xpm
WE ./textures/west_texture.xpm
NO ./textures/north_texture.xpm
F 220,100,0
C 225,30,0

            1111111111111111111111111
            1000000000110000000000001
            10110000011100000000000A01
         1  1001000000000000000000001
1111111110110000011100000000000011111
10000000001100000111011111111111
11110111111111011100000010001
11110111111111011101010010001
11000000110101011100000010001
10000000000000001100000010001
10000000000000001101010010001
11000001110101011111011110N01
11110111 1110101 101111010001
11111111 1111111 111111111111