NO ./textures/north_texture.xpm
SO ./textures/south_texture.xpm
WE ./textures/west_texture.xpm
EA ./textures/east_texture.xpm

F 80,80,80
C 180,180,180

111111111111
100000000001
101111101101
10W000001001
111101111101
100001000001
111111111111
