NO ./textures/north_texture.xpm
SO ./textures/south_texture.xpm
WE ./textures/west_texture.xpm
EA ./textures/east_texture.xpm

F 100,100,100
C 200,200,200

111111111111
100000000001
101101110101
100000S00001
111111111111