F 80,120,80
EA ./textures/east_texture.xpm
SO ./textures/south_texture.xpm
WE ./textures/west_texture.xpm
NO ./textures/north_texture.xpm
C 180,220,180

111111111111111
1000000000000001111111111
1111111111111100000000001
             101111111101
    11111111 101      101
111110000001110111    101
100000000000000001    101
101101110101111111    101
10W000001001          101
111101111101111111    101
100001000000000001    101
1111111111111011111111101
            1000000000001
            1111111111111




