F 80,120,80
EA ./textures/east_texture.xpm
SO ./textures/south_texture.xpm
WE ./textures/west_texture.xpm
NO ./textures/north_texture.xpm
C 180,220,180

    11111111
111110000001111111
100000000000000001
101101110101111111
10W000001001
111101111101111111
100001000000000001
111111111111111111
